10 10 255 255 255 5 255 255 255 5 255 255 255 5 255 255 255 5 255 255 255 5 255 255 255 5 255 255 255 5 255 255 255 5 255 255 255 5 255 255 255 5 255 255 255 5 255 255 255 5 255 255 255 5 255 255 255 5 255 255 255 5 255 255 255 5 255 255 255 5 255 255 255 5 255 255 255 5 255 255 255 5 255 255 255 5 255 255 255 5 255 255 255 5 255 255 255 5 255 255 255 5 255 255 255 5 255 255 255 5 255 255 255 5 255 255 255 5 255 255 255 5 255 255 255 5 255 255 255 5 255 255 255 5 255 255 255 5 255 255 255 5 255 255 255 5 255 255 255 5 255 255 255 5 255 255 255 5 255 255 255 5 255 255 255 5 255 255 255 5 255 255 255 5 255 255 255 5 255 255 255 5 255 255 255 5 255 255 255 5 255 255 255 5 255 255 255 5 255 255 255 5 255 255 255 5 255 255 255 5 255 255 255 5 255 255 255 5 255 255 255 5 255 255 255 5 255 255 255 5 255 255 255 5 255 255 255 5 255 255 255 5 255 255 255 5 255 255 255 5 255 255 255 5 255 255 255 5 255 255 255 5 255 255 255 5 255 255 255 5 255 255 255 5 255 255 255 5 255 255 255 5 255 255 255 5 255 255 255 5 255 255 255 5 255 255 255 5 255 255 255 5 255 255 255 5 255 255 255 5 255 255 255 5 255 255 255 5 255 255 255 5 255 255 255 5 255 255 255 5 255 255 255 5 255 255 255 5 255 255 255 5 255 255 255 5 255 255 255 5 255 255 255 5 255 255 255 5 255 255 255 5 255 255 255 5 255 255 255 5 255 255 255 5 255 255 255 5 255 255 255 5 255 255 255 5 255 255 255 5 255 255 255 5 255 255 255 5 255 255 255 5
10 11 255 255 255 5 255 255 255 5 255 255 255 5 255 255 255 5 255 255 255 5 255 255 255 5 255 255 255 5 255 255 255 5 255 255 255 5 255 255 255 5 255 255 255 5 255 255 255 5 255 255 255 5 255 255 255 5 255 255 255 5 255 255 255 5 255 255 255 5 255 255 255 5 255 255 255 5 255 255 255 5 255 255 255 5 255 255 255 5 255 255 255 5 255 255 255 5 255 255 255 5 255 255 255 5 255 255 255 5 255 255 255 5 255 255 255 5 255 255 255 5 255 255 255 5 255 255 255 5 255 255 255 5 255 255 255 5 255 255 255 5 255 255 255 5 255 255 255 5 255 255 255 5 255 255 255 5 255 255 255 5 255 255 255 5 255 255 255 5 255 255 255 5 255 255 255 5 255 255 255 5 255 255 255 5 255 255 255 5 255 255 255 5 255 255 255 5 255 255 255 5 255 255 255 5 255 255 255 5 255 255 255 5 255 255 255 5 255 255 255 5 255 255 255 5 255 255 255 5 255 255 255 5 255 255 255 5 255 255 255 5 255 255 255 5 255 255 255 5 255 255 255 5 255 255 255 5 255 255 255 5 255 255 255 5 255 255 255 5 255 255 255 5 255 255 255 5 255 255 255 5 255 255 255 5 255 255 255 5 255 255 255 5 255 255 255 5 255 255 255 5 255 255 255 5 255 255 255 5 255 255 255 5 255 255 255 5 255 255 255 5 255 255 255 5 255 255 255 5 255 255 255 5 255 255 255 5 255 255 255 5 255 255 255 5 255 255 255 5 255 255 255 5 255 255 255 5 255 255 255 5 255 255 255 5 255 255 255 5 255 255 255 5 255 255 255 5 255 255 255 5 255 255 255 5 255 255 255 5 255 255 255 5 255 255 255 5 255 255 255 5
10 12 255 255 255 5 255 255 255 5 255 255 255 5 255 255 255 5 255 255 255 5 255 255 255 5 255 255 255 5 255 255 255 5 255 255 255 5 255 255 255 5 255 255 255 5 255 255 255 5 255 255 255 5 255 255 255 5 255 255 255 5 255 255 255 5 255 255 255 5 255 255 255 5 255 255 255 5 255 255 255 5 255 255 255 5 255 255 255 5 255 255 255 5 255 255 255 5 255 255 255 5 255 255 255 5 255 255 255 5 255 255 255 5 255 255 255 5 255 255 255 5 255 255 255 5 255 255 255 5 255 255 255 5 255 255 255 5 255 255 255 5 255 255 255 5 255 255 255 5 255 255 255 5 255 255 255 5 255 255 255 5 255 255 255 5 255 255 255 5 255 255 255 5 255 255 255 5 255 255 255 5 255 255 255 5 255 255 255 5 255 255 255 5 255 255 255 5 255 255 255 5 255 255 255 5 255 255 255 5 255 255 255 5 255 255 255 5 255 255 255 5 255 255 255 5 255 255 255 5 255 255 255 5 255 255 255 5 255 255 255 5 255 255 255 5 255 255 255 5 255 255 255 5 255 255 255 5 255 255 255 5 255 255 255 5 255 255 255 5 255 255 255 5 255 255 255 5 255 255 255 5 255 255 255 5 255 255 255 5 255 255 255 5 255 255 255 5 255 255 255 5 255 255 255 5 255 255 255 5 255 255 255 5 255 255 255 5 255 255 255 5 255 255 255 5 255 255 255 5 255 255 255 5 255 255 255 5 255 255 255 5 255 255 255 5 255 255 255 5 255 255 255 5 255 255 255 5 255 255 255 5 255 255 255 5 255 255 255 5 255 255 255 5 255 255 255 5 255 255 255 5 255 255 255 5 255 255 255 5 255 255 255 5 255 255 255 5 255 255 255 5
10 13 255 255 255 5 255 255 255 5 255 255 255 5 255 255 255 5 255 255 255 5 255 255 255 5 255 255 255 5 255 255 255 5 255 255 255 5 255 255 255 5 255 255 255 5 255 255 255 5 255 255 255 5 255 255 255 5 255 255 255 5 255 255 255 5 255 255 255 5 255 255 255 5 255 255 255 5 255 255 255 5 255 255 255 5 255 255 255 5 255 255 255 5 255 255 255 5 255 255 255 5 255 255 255 5 255 255 255 5 255 255 255 5 255 255 255 5 255 255 255 5 255 255 255 5 255 255 255 5 255 255 255 5 255 255 255 5 255 255 255 5 255 255 255 5 255 255 255 5 255 255 255 5 255 255 255 5 255 255 255 5 255 255 255 5 255 255 255 5 255 255 255 5 255 255 255 5 255 255 255 5 255 255 255 5 255 255 255 5 255 255 255 5 255 255 255 5 255 255 255 5 255 255 255 5 255 255 255 5 255 255 255 5 255 255 255 5 255 255 255 5 255 255 255 5 255 255 255 5 255 255 255 5 255 255 255 5 255 255 255 5 255 255 255 5 255 255 255 5 255 255 255 5 255 255 255 5 255 255 255 5 255 255 255 5 255 255 255 5 255 255 255 5 255 255 255 5 255 255 255 5 255 255 255 5 255 255 255 5 255 255 255 5 255 255 255 5 255 255 255 5 255 255 255 5 255 255 255 5 255 255 255 5 255 255 255 5 255 255 255 5 255 255 255 5 255 255 255 5 255 255 255 5 255 255 255 5 255 255 255 5 255 255 255 5 255 255 255 5 255 255 255 5 255 255 255 5 255 255 255 5 255 255 255 5 255 255 255 5 255 255 255 5 255 255 255 5 255 255 255 5 255 255 255 5 255 255 255 5 255 255 255 5 255 255 255 5 255 255 255 5
10 14 255 255 255 5 255 255 255 5 255 255 255 5 255 255 255 5 255 255 255 5 255 255 255 5 255 255 255 5 255 255 255 5 255 255 255 5 255 255 255 5 255 255 255 5 255 255 255 5 255 255 255 5 255 255 255 5 255 255 255 5 255 255 255 5 255 255 255 5 255 255 255 5 255 255 255 5 255 255 255 5 255 255 255 5 255 255 255 5 255 255 255 5 255 255 255 5 255 255 255 5 255 255 255 5 255 255 255 5 255 255 255 5 255 255 255 5 255 255 255 5 255 255 255 5 255 255 255 5 255 255 255 5 255 255 255 5 255 255 255 5 255 255 255 5 255 255 255 5 255 255 255 5 255 255 255 5 255 255 255 5 255 255 255 5 255 255 255 5 255 255 255 5 255 255 255 5 255 255 255 5 255 255 255 5 255 255 255 5 255 255 255 5 255 255 255 5 255 255 255 5 255 255 255 5 255 255 255 5 255 255 255 5 255 255 255 5 255 255 255 5 255 255 255 5 255 255 255 5 255 255 255 5 255 255 255 5 255 255 255 5 255 255 255 5 255 255 255 5 255 255 255 5 255 255 255 5 255 255 255 5 255 255 255 5 255 255 255 5 255 255 255 5 255 255 255 5 255 255 255 5 255 255 255 5 255 255 255 5 255 255 255 5 255 255 255 5 255 255 255 5 255 255 255 5 255 255 255 5 255 255 255 5 255 255 255 5 255 255 255 5 255 255 255 5 255 255 255 5 255 255 255 5 255 255 255 5 255 255 255 5 255 255 255 5 255 255 255 5 255 255 255 5 255 255 255 5 255 255 255 5 255 255 255 5 255 255 255 5 255 255 255 5 255 255 255 5 255 255 255 5 255 255 255 5 255 255 255 5 255 255 255 5 255 255 255 5 255 255 255 5